(sich in ein Tuch) schnäuzen		to blow one’s nose
abfädmen		den faden herunter ziehen, abwinden (veraltet)
Abfindung		compensation/indemnity payments (odškodnina/poravnava)
abgedroschen		banal
abgekartet		rigged/vnaprej dogovorjen 
abschirmen		vor jemandem, etwas schützen, gegen jemanden, etwas absichern, isolieren, nicht zur Wirkung kommen lassen ODER etwas zuruückhalten (typischerweise Licht)
abschlägig		negative/refusing
absonderlich		vom Gewöhnlichen, Üblichen abweichend
abzusezten		to remove ODER to take off
Aderlass		bleeding
ahnungsvoll		von Ahnung (1) erfüllt; etwas [Schlimmes] ahnend
Alkoholfahne		unangenehmer Geruch des Atems nach Alkohol
anfechten (angefochten PER)		contest/disputed
anmaßend		arrogant
anorektisch		die Anorexie betreffend; magersüchtig
Anrainer		benachbarter Staat/neigbouring country ODER (ÖER) local resident
anschneiden		durch Abschneiden des ersten Stückes zu verbrauchen beginnen ODER zur Sprache bringen
Anspielung		reference
anzüglich		auf etwas Unangenehmes anspielend
Anzüglichkeiten		suggestive advances
Arg		Falschheit, Boshaftigkeit, Böses
arg		schlimm/terrible ODER stark/sehr
Arglist		malice/malevolence
arglos		innocent
Argwohn		suspicion
argwöhnisch		suspicious
Aue		meadow/pasture
Auf den Arm nehmen		sich über jemanden lustig machen
auf der Stelle treten		nicht vorankommen; keine Fortschritte erzielen
auf etw erpicht sein		sich stark für etw interessieren
aufbrausend		zornig und leicht erregbar
aufgären		ferment (Gärung)
Aufwallung		surge/wave of sth
aufwühlen		razburkati
Augenstern		1) Liebling ODER 2) Pupille
auserkoren		chosen
ausfransen		(von Textilien, besonders Kleidungsstücken) sich an den Rändern in Fasern auflösen, ausfasern
Auslese		Elite/chosen few/superior selection/natural selection
ausmerzen		ausrotten, vertilgen, eliminieren
ausposaunen		[etwas, was nicht bekannt werden sollte] überall erzählen
Ausschweifen		Hedonismus: Maßlosigkeit, Übertreibung, besonders im Lebensgenuss; Zügellosigkeit; Exzess
ausschweifend		hedonistic/wild
Aussickern		curljanje/pronicanje
ausstaffiert		ausstatten, ausrüsten
ausstoben		(wütend sein) ungezügelt toben, wild spielen, seine überschüssige Kraft ungezügelt verausgaben
Bändel		Schnürsenkel/shoelace ODER ribbon (Bändchen)
bang		scared/frightened/uneasy
bedächtig		deliberate/thoughtful/careful
begriffsstutzig		ÖER schwer begreifend
begutachten		to examine sth/to have a look at
behelligen		to bother/to trouble (darf ich Sie noch einmal mit einer Frage behelligen)
Beichte		confession
beipflichten (jdm/etw beipflichten)		to agree with sb/sth
beklommen		anxious, uneasy
Beklommenheit		anxiety/uneasiness
belassen (beließ PRÄ)		to leave it at sth (stehen lassen/Status Quo erhalten)
Beschaffenheit		Zustand ODER composition ODER qualität
bescheiden		modest/plain/humble ODER [etw bescheiden] to decide upon sth ODER zuteilen
beschwichtigen		beruhigend auf jemanden, etwas einwirken
beschwipst		leicht betrunken [und ausgelassen]
beständig		consistent/constant ODER resistant/resilient/lasting
Birke		birch tree
Blutegel		leech
Boje		verankerter Schwimmkörper, der als Seezeichen oder zum Vertäuen von Schiffen dient
Bollwerk		Festung ODER Privez (nautic)
borgen		ausleihen
borniert		engstirnig und zugleich in ärgerlicher Weise eingebildet und auf seinen Vorstellungen beharrend
borstig		ščetinast
Brandung		coast (charakteristisch laut wegen Wellen)
Brechreiz		Gefühl sich übergeben zu müssen
Bretterhaus		≈Bude aus Bretten (lesene paličice)
brisant		eksploziven/razdiralen ODER odmeven/vroča tema
Brodem		[üblen] Geruch ausströmender Dunst oder Dampf
brünstig		horny
brüsk		in unerwartet unhöflicher Weise barsch, schroff
Büchse		Dose (tin can) ODER Jagdgewehr
bugsieren		ins Schlepptau nehmen und an eine bestimmte Stelle bringen; schleppen
bündig		concise/concisely (jedernat)
bunt­sche­ckig		bunt gefleckt
Busen		breast
Degen		(Steierisch-Slowenisch z degn štohn) frühere Hieb- und Stichwaffe mit Griff und schmaler, gerader und spitzer Klinge
Demut		Humility: in der Einsicht in die Notwendigkeit und im Willen zum Hinnehmen der Gegebenheiten begründete Ergebenheit
den Faden verlieren		sich verwirren beim Sprechen ODER vergessen, was man eigentlich sagen wollte
der Groschen ist gefallen		Wenn jemand richtig lange braucht, bis er einen Witz kapiert oder eine Sache verstanden hat. Dann sagt man auch "Der Groschen ist gefallen".
derb		1) fest, stabil, wiederstandsfähig ODER kräftig, stark ODER unfreundlich
die Fliege machen		abhauen, schnell verschwinden
die Mücke machen		abhauen, schnell verschwinden
die Runde machen		1) herumerzählt werden, an Bekanntheit erlangen 2) von einer Hand zur anderen weitergereicht werden
Diele		Vorraum ODER central living room (NORDDEU)
Dilletant		männliche Person, die sich mit einem bestimmten [künstlerischen, wissenschaftlichen] Gebiet nicht als Fachmann, sondern lediglich aus Liebhaberei beschäftigt ODER männliche Person, die ihr Fach nicht beherrscht
Dirne		prostitute
dösen		leicht, nicht tief schlafen; sich in einem Zustand von Halbschlaf befinden
dreist		frech, unverschämt
dröhnen		to roar/to boom/to rumble/to reverberate
drosseln		jemandem die Kehle zudrücken; würgen ODER die Zufuhr von etwas verringern
Drudenfuß		pentagram
dumpf		dull, vague, lifeless ODER feucht-muffig
dünken (jdm dünkt etw)		jemandem so vorkommen, scheinen ODER sich zu Unrecht etwas einbilden, sich für etwas halten
düpieren		täuschen, überlisten, zum Narren halten
Dust		feinste Teeaussiebung (filtered tea)
ehrerbietig		respectful
eigentümlich		merkwürdig ODER typisch/characterist
eilfertig		1) übereilig, vorschnell 2) dienstbeflissen
ein Schnitzer		Woodcarver ODER blunder (faux pas)
einstweilen		vorläufig ODER in der Zwischenzeit
einträchtig		harmonious
Einverleibung		annexation/incorporation/takeover
Einvernehmen		(mutual) agreement
Eitelkeit		vanity
Emsigkeit		rastloser Fleiß, unermüdliche Tätigkeit
engstirnig		in Vorurteilen befangen; sehr einseitig denkend, kurzsichtig; borniert
ent­sprie­ßen		aus etwas hervorgehen
Erfordernisse		Requirements
Ergebenheit		Treue, Fügsamkeit, Hingegebensein
ergetzen		(=) ergötzen : to amuse sb, to take delight in sth
ermatten		schlapp, matt werden; (bei etwas) an Kraft verliern, stumpf, schwach werden
Erquickung		refreshment
Erschwoll		?
Etw an jmd verpachten		to lease/rent sth to sb
etw einbüßen		to lose sth
etw in der Schwebe halten		to balance sth
Fähnchen		kleine Fahne/kleines Kleid
Famulus		medical student doing practical work in a clinic 
fehl am Platze sein		nicht hineinpassen
feilschen		bei einem Kauf durch hartnäckiges, kleinliches Handeln einen möglichst günstigen Preis für etwas, den größtmöglichen Vorteil zu erreichen suchen
fichten		aus Fichtenholz bestehend
Fiedel		violina
Fingerzeig		hint/pointer/to give sb a hint
Firnis		Wasserfirnis; schnell trocknendes, farbloses Öl, das als Schutzschicht auf etwas aufgetragen wird
Fittich		Flügel
flache Senke		ploščat spust (GEO depresija)
Flatschen		auf dem Boden liegende breiige Masse
Flaute		sehr geringe Bewegung der Luft ODER Zeit, in der keine Nachfrage herrscht ODER vorübergehende Leistungsschwäche, Lustlosigkeit
Fliege (Kleidung)		als Querschleife gebundene Krawatte
forsch		bold/confident
Fotze		(vulgär) Frau/Vagina ODER Ohrfeige
freilich		1) allerdings (though) ODER 2) (SÜDDEU) of course
frönen		to indulge
fummeln		(to fumble) mečkanje ODER brskanje po (wenn fummeln an + DAT)
Furche		(BILD Links) jama na njivah
Futterale		etui
Gabelung		fork (junction)/point of diversion
gaffen		zijati/buljiti/to stare at something
Gähnen		yawn
Galatag		Ein alter Feiertag in Mitteldeutschland (Hessen/Thüringen)
gangbar		passable (begehbar) ODER practicable/a practicable solution
Garn		nit (auch Faden)
garstig		bad/naughty
Gärung		fermentation
Gaumen (im Mund)		nebo v ustih
Gebälk		ogredje,póvezje/timberwork,beams
geckenhaft		expressive in extreme elegance in clothes and manners
Gefilde		scenery/pastures
Gehsteig		Gehweg (pavement/pločnik)
geistreich		intellectually stimulating/bright/witty
geläufig		gewöhnlich ODER bekannt ODER fließend
gelind		mild, mäßig ODER (umgangsprachlich) heftig
Gemengelage		scattered patches of arable land
Gemüt		Gesamtheit der psychischen und geistigen Kräfte eines Menschen ODER geistig-seelisches Empfindungsvermögen; Empfänglichkeit für Gefühle erregende Eindrücke
genieren (sich genieren)		to be embarrassed/shy
Gepflogenheiten		habit
gerinnen		(von Milch, Blut o. Ä.) feine Klümpchen, Flocken bilden und dadurch dickflüssig, fest, klumpig, flockig werden; stocken
Gerüttel		dauerndes heftiges schütteln
gescheit		clever/bright/quick-witted
geschweift		mit Schwanz ODER gebogen/gewölbt
gespreizt		spread
Getümmel		commotion ODER dense mob of people
gewappnet zu sein		to be prepared for
gewiefter		entweder I. cunning oder II. crafty, witty
Gewimmel		swarming mass/crowd/throng
Gewühl		throng/crowd ODER andauerndes Kramen
Gezeter		ärgerlich, unzufrieden, vor Wut, Zorn o. Ä. [mit lauter, schriller Stimme] schimpfen, jammern
Gleichnis		kurze bildhafte Erzählung, die einen abstrakten Gedanken oder Vorgang durch Vergleich mit einer anschaulichen, konkreten Handlung [mit belehrender Absicht] verständlich machen will
gleißen		stark und spiegelnd [metallisch] glänzen
glucksen		(=gluckern) to glug/gurgle (Laut das durch das Fließen einer Flüßigkeit entsteht)
Glut		glühende Masse ODER Leidenschaft
Gönner		patron/sugardaddy (pokróvitelj)
gönnerhaft		patronisingly
Gram		grief/sorrow
Gräschen		Verkleinerungsform zu Gras
Grausen		Horror/the act of being terrified of sth
grell		in unangenehmer Weise hell; blendend hell
grillenhaft		launenhaft, sonderbar, wunderlich
grimmig		furious, angry
Grind		Hautausschlag, der sich zu einer Kruste verhärtet und Wundschorf
grindig		beschmutzt und mit Grind bedeckt
Grips haben		clever/have brains
grobschlächtig		heavily built
Groll		resentment/grudge
grübeln		seinen oft quälenden, unnützen oder fruchtlosen Gedanken nachhängen; über eine Sache nachsinnen, um zu einer Lösung oder Klärung zu kommen
Gunst		goodwill/favour/advantage
Gutachten		expert’s report
habgierig		gierig (greedy/avaricious)
Hader		[über lange Zeit] schwelender, mit Erbitterung ausgetragener Streit/Unzufriedenheit ODER Stoffrest, -abfall; Lumpen (ÖER)
Hagestolz		älterer, eingefleischter, etwas kauziger Junggeselle (confirmed bachelor 
hämisch		malicious
Hampelmann		Übung, bei der man aus der Grundstellung in eine leichte Grätsche springt, gleichzeitig beide Arme seitlich hochschwingt, über dem Kopf in die Hände klatscht und anschließend wieder die Ausgangsposition einnimmt ODER aus Holz, Pappe oder dergleichen hergestelltes, an die Wand zu hängendes Kinderspielzeug in Gestalt eines Mannes (besonders eines Kaspers, einer Märchenfigur oder dergleichen), der, wenn man an einem daran befestigten Faden zieht, Arme und Beine waagerecht vom Körper abspreizt und Unterschenkel und Unterarme nach unten baumeln lässt
handhabbar		managable
Handhabe		 tangible evidence /  to have something/nothing on sb 
Hanswurst		derbkomische Figur des deutschen Theaters des 18. Jahrhunderts ODER dummer Mensch, den man nicht ernst nimmt, der sich lächerlich macht
Hantel		ročaj/ročka
hartgesotten		(aufgrund seiner Erlebnisse) nicht mehr zu beeindrucken, für Gefühle nicht empfänglich; berechnend, kalt ODER unbelehrbar, unzugänglich, verstockt
Havarie		(ÖER) accident (typically car accident)
hecheln		spöttische, boshafte Reden über andere führen; über jemanden, etwas herziehen, klatschen ODER (besonders von Hunden) mit offenem Maul und heraushängender Zunge rasch und hörbar atmen ODER mit der Hechel oder in der Hechelmaschine bearbeiten
Hecke		Anzahl dicht beieinanderstehender Sträucher, Büsche mit vielen Zweigen; Gesträuch ODER Zeit der Paarung und des Brütens; Brutzeit
Hecken		hedge (živa meja) ODER zadek avta
hegen		entweder I. to feel something towards, II. to protect oder III. to tend
heikel		delicate/awkward/tricky
heillos		terrible/hopelessly
Hengst		Stallion
hervorlugen		to peep out (to appear)
Heuchelei		hypocrisy
heuchlerisch		von Heuchelei zeugend, Heuchelei enthaltend; geheuchelt
hieven		(=) heben/to pull/ push up
hochkantig		auf die, auf der Schmalseite (z.B. die Bücher hochkant ins Regal stellen)
hochnäsig		arogant
Hodensack		eiersack
hold		dear/beloved/sweet/kind
holprig		bumpy/uneven/clumsy
Holzspäne		(=) Sägespäne
Hornisse		großes, zu den Wespen gehörendes Insekt
Huld		favour/grace
Hülfe		Hilfe
Hülften		??
hüllen		to wrap sb in sth, shroud in sth
hünenhaft		groß und eine breite, kräftige Statur aufweisend, die den Eindruck von besonderer Stärke erweckt
in den Bann schlagen		to fascinate/influence sb
in der Schwebe halten/sein/lassen		1) to balance something 2) to be in balance 3) to leave smth undecided
in die Binsen gehen		missglücken S ; misslingen
ins Lot bringen		etwas in Ordnung bringen
ins stocken geraten		nicht vorankommen, nicht weitergehen
inwendig		inside
jäh		abrupt ODER sheer/steep
jauchzen		rejoice
jemand aufs Kreuz legen		jemanden hereinlegen/betrügen
jemanden [für etwas] schadlos halten		besonders Rechtssprache, Wirtschaft: jemanden [für etwas] entschädigen
jmd in die Mangel nehmen		auf jemanden großen Druck ausüben
Joch		auf der Stirn bzw. dem Nacken aufliegender Teil des Riemenzeug, mit dem Zugtiere vor den Wagen gespannt werden
Johlen		to yell
Kabbelei		kleiner, harmloser Streit; Wortgefecht
Kachel		tile/ploščica
Kai		durch Mauern befestigtes Ufer im Bereich eines Hafens, an dem die Schiffe anlegen und be- und entladen werden
Kante		edge/border (Rand)
Kasperei		Klaunerei
kauzig		odd/strange
keck		vorlaut (cheeky/saucy), provokant/bold
kehrtmachen		sich [rasch] umdrehen, [spontan] umkehren
Keimbahn		Unter der Keimbahn versteht man beim Menschen und bei den meisten Tieren die Abfolge von Zellen, die, beginnend bei der befruchteten Eizelle (Zygote), im Laufe der Individualentwicklung des betreffenden Lebewesens schließlich zur Bildung seiner Keimdrüsen und der darin gebildeten Keimzellen (Eizellen und Spermien) führt.
Kies		gravel
kiesbestreut		spread with gravel
kiffen		Haschisch oder Marihuana rauchen
klamm		1) steif vor Kälte (numb) ODER 2) nass und kalt ODER 3) über wenig Geld verfügend
Klee		clover
Klinke		door handle
klobig		hefty/bulky/massive
knauserig		geizig, kleinlich sparend auch in allen Dingen des täglichen Haushalts
Knausern		knauseriges Handeln
Kneifzange		(=)Brechzange/Klešče
kniffelig		tricky/hard to fix
Knirschen		Crunched/Grinded stuff
Knospung		BrstenjeEcke
Koller		rage/anger
konsequent		consistent/steadfast/resolute (folgerichtig/entschlossen)
Körnung		in Körner zerkleinert
Kot		feces/excrement
krakeelen		noisy arguing
Krämerei		kleiner Laden (veraltet, landschaftlich)
kraus		kodrast/naguban ODER verwirrt
Kräusel		curl
Kräuselung		curliness
krepieren		(von Sprenggeschossen) durch Zündung eines Sprengstoffs zerplatzen, sodass Teile oder Splitter durch die Luft fliegen ODER (von Tieren) verenden, elend sterben
kritteln		to find faullts
Krücke		Stock für Gehbehinderte (crutch) ODER Nicthskönner ODER untaugliches Gerät (junk)
Krug		jug/mug ODER pub (NORDDEU)
krümmen		to bend, to arch ODER to writhe in pain
Kuhfladen		kravjek
Kundgebung		Versammlung/rally ODER Erklärung/razglas
kupplerisch		jemand der Kuppelei (sexuelle Unzucht) fordert 
Kurzsinn		Eingeengtheit, Beschränktheit
laben		mit Speise oder Trank erquicken, erfrischen, sich [an etwas] gütlich tun
Labsal		etwas, was jemanden erfrischt
Laffe		(=Lackaffe) showboat (Angeber)
Landzunge		rt (SLO)/headland
Latwerge		1) breiig zubereitetes Arzneimittel 2) Frucht-, besonders Pflaumenmus
lechzen		(nach etwas, was jemand [für seine Existenz] dringend braucht oder herbeisehnt) mit heftiger Begierde verlangen
lediglich		weiter nichts als; nur
leimen (etw oder jdn leimen)		to glue sth together ODER jemanden hereingelegt zu haben
Lerche		škrjanec (vrsta ptice)
letzen		To refresh sb ODER to feast on sth
Leutseligkeit		affability (verbindlichkeit)
liebkosen (jmd liebkosen)		ljubkovati
Linde		Lipa
Linderung		relief/mitigation
lispeln		šušljanje/šepetanje
List		Mittel, mit dessen Hilfe jemand (andere täuschend) etwas zu erreichen sucht, was er auf normalem Wege nicht erreichen könnte
lodern		blazing/spreading fire
Lohe		flames (typically raging flames) ODER zum Gerben verwendete, zerkleinerte Rinde, besonders von jungen Eichen und Fichten; Gerberlohe
Luder		crafty bitch/stupid brat/hussy
Lümmel		mulec (small fellow)
lüppen		gerinnen lassen
manisch		maniacal/besessen
mannigfaltig		[in großer Anzahl vorhanden und] auf vielerlei Art gestaltet
Mär		[Märchen] fairytale
mäßig		moderate/mediocre/so-so
mich deucht		I think/=Ich denke
Misshelligkeiten		nicht sehr ernsthaftes Zerwürfnis (conflict)/ small feud
mit etw reüssieren		to succeed in doing sth
mit jdm Krach haben		to have a row with somebody
mit Verlaub		with respect (forgive me for saying so)
morsch		rotten/decomposing/decaying
Muhme		Tante
mulmig		uneasy/uncomfortable/precarious
Mumm		to have guts/bravery
munter		bright/sharp/quick-witted ODER lively ODER wach
Munterkeit		heiter, gut gelaunt, aufgeweckt und lebhaft ODER wach
mürrisch		grumpy
Napf		kleine [flache] runde Schüssel (besonders als Gefäß für das Futter von Haustieren, auch als einfaches Essgefäß)
närrisch		relating to carnival ODER mad
naseweis		(meist von Kindern) vorwitzig, vorlaut (nosey/precocious/Besserwisser)
necken		to tease
nieseln		leicht, in feinen [dicht fallenden] Tropfen regnen
nisten		to nest
nubisch		of, relating to, or characteristic of Nubia, its people, or their language.
Obhut		In sb’s care/in charge
offen zu Tage treten		sichtbar werden 
Partitur		score
penibel		skrben/pedanten
Persiflage		satire
Pfaffen		cleric
Pfosten		Pfahl/jamb/post
pingelig		übertrieben gewissenhaft; pedantisch genau
plump		1) plump/massive 2) awkward 3) obvious
Pöbel		mob
pochen		klopfen
pomadisieren		mit Pomade (fetthaltige, salbenähnliche Substanz zur Haarpflege, besonders zur Festigung des Haars bei Männern) einreiben
prägnant		concise/concisely (jedernat)
Prater		Park in Wien
preskär		??
Pritsche		sehr einfache, schmale, meist aus einem Holzgestell bestehende Liegestatt ODER Prostitutierte
Puck		Kobold, schalkhafter Elf ODER Scheibe aus Hartgummi für Eishockey
pummelig		plumb/chubby
quengelig		whining
quillen		(=)quellen
quirlig		lively
radotieren		ungehemmt schwatzen
Ränke (schmieden)		Planning plots
Räson		reason
Rauferei		fight
raunen		šepetati
Rauschgift		Drug/narcotic
rauschhaft		Dionysiac
Reben		Vines
Rendite		return/yield
Riemen		Gürtel ODER längeres, mit beiden Händen bewegtes Ruder
ruchbar werden, dass…		to become known that…
Rückgrat		Wirbelsäule
Saat		sejanje
Sahnehäubchen		the icing on the cake
säumen		1) to edge/margin/line something 2) spread
Schacher		(antisemitisch) von Gewinnsucht, von kleinlichem, hartnäckigem Streben nach dem größtmöglichen Vorteil bestimmtes Aushandeln von Preisen, von geschäftlichen Abmachungen
schadlos		keinen Schaden verursachend; unschädlich
Schale		lupina ODER skleda (ÖER)
Schalk		rogue/scoundrel
schändlich		Empörung hervorrufend; niederträchtig, gemein ODER unerhört; sehr, überaus schlecht
Schanze		als Verteidigungsanlage aufgeworfener Erdwall für einen militärischen Stützpunkt [im Feld]
Schar 		größere Anzahl von zusammen auftretenden Menschen oder Tieren
scharen		to gather, swarm, to rally around smth
schartig		jagged/ragged
schauderhaft		ghastly/horrific/terrible (grässlich/furchtbar)
Scheitel		Teilung der Frisur ODER Vertex/zenith/apex
Schelm		navihanec/tat/männliche Person, die gern anderen Streiche spielt, Spaßvogel; schelmischer (1) Mann, Schalk
schelten		beschimpfen, tadeln, kritisieren
schemenhaft		shadowy ODER to make out the outline of sth in the dark
schier		sheer
schildern		to describe sth/to give an exhaustive account of sth
schillernd		in wechselnden Farben, Graden von Helligkeit glänzend ODER verschwommen, schwer durchschaubar
schinden (geschunden PER)		to work oneself to death/to slave away ODER to ill treat ODER to receive
Schlappohr		(bei bestimmten Tieren) herunterhängendes Ohr
Schleicher		simp/arse-licker (sycophant)
Schleier		tančica für Gesicht ODER Nebel/Dunst
schlendern		to stroll
schlicht		simple
Schliff		durch gleichmäßiges Reiben der Oberfläche an etwas Rauem (z. B. an einem Schleifstein, Wetzstahl o. Ä.) schärfen (ein Messer schleien) ODER die Oberfläche von Glas, Edelsteinen o. Ä. mit einem Werkzeug oder einer Maschine bearbeiten, sodass eine bestimmte Form entsteht; glätten
Schlips		Krawatte
Schlote		vent(Tiefsee vulkanische Schloten) /chimney
schlüssig		folgerichtig(logical)/conclusive(eindeutig) ODER im Klaren (one’s made is already made up)
Schmach		humiliation/shame
schmächtig		dünn und von zartem Gliederbau
schmatzen		cmokanje (squelch ENG)
Schmaus		feast
schmausen		vergnügt und mit Genuss essen
Schmiere stehen		Wache halten
schmuddelig		mit [klebrigem, schmierigem] Schmutz behaftet; unsauber, schmutzig und unordentlich
schmunzeln		grinning
schnalzen		finger or tongue snap (á la tsk tsk)
schnattern		(besonders von Gänsen und Enten) schnell aufeinanderfolgende, helle, harte, fast klappernde Laute von sich geben ODER eifrig, hastig [und aufgeregt] über allerlei [unwichtige und alberne] Dinge reden; schwatzen
Schnauben		snorting/loud blowing of one’s nose
Schneid haben		Mut oder Kraft zu etwas haben
Schneifel		ein Teil der Eifel
schrill		shriekingly
schroff		steil/steep ODER brusquely/demeaningly ODER abrupt
schubweise		in phases/in batches
Schuft		rogue/villain
schuften		to slave away
Schuhu		(=Uhu) (zu den Eulen gehörender) großer, in der Dämmerung jagender Vogel mit gelbbraunem, dunkelbraun geflecktem Gefieder, großen, orangeroten Augen, dickem, rundem Kopf und langen Federn an den Ohren
schürfend		scraping for sth/digging
schwafeln		čvékati/nakladati
schwappen		(von Flüssigem) sich in etwas hin und her bewegen, überfließen [und dabei ein klatschendes Geräusch verursachen]
schwärmen		in Schwarm fliegen ODER begeistert reden über/begeistert sein
Schwärmerei		Wunschtraum/Passion/Begeisterungsreden
Schweif		tail (rep)
schweifen		to roam/wander/gaze
schwelgen		to indulge
Schwelle		(typically Türschwelle) threshold
sehnig		kitast/mišičast/žilast
Sehnsucht		longing/yearning
seicht		shallow
sein Fähnchen nach dem Wind hängen		to go with the flow
selig		[von allen irdischen Übeln erlöst und] des ewigen Lebens, der himmlischen Wonnen teilhaftig, einem tiefen [spontanen] Glücksgefühl hingegeben
Sennen		Alpine pastures (planina) (ÖER/CHE)
sich an jdm/etw shadlos halten		to make sb pay for sth/to do justice to sth
sich nötigen lassen		gezwungen werden
siebern		Speichel aus dem Mund laufen lassen
sinnen (sann PER)		to brood/ponder/plot
Sittich		(in Amerika, Afrika, Südasien und Australien heimischer) kleiner, meist sehr bunt gefärbter Vogel mit langem, keilförmigem Schwanz
Soldatenschwänken		??
Spat		Mineral, das sich beim Brechen blättrig spaltet ODER Gelenkenentzündung
Spaten		(zum Umgraben, Abstechen und Ausheben von Erde o. Ä. bestimmtes) Gerät aus einem viereckigen, unten mit einer Schneide versehenen [Stahl]blatt und langem [Holz]stiel mit einem als Griff dienenden Querholz am Ende
Spezereien		Delikatessen (ÖER) ODER überseeisches Gewürz
spießbürgerlich		wie eine engstirnige männliche Person, die sich an den Konventionen der Gesellschaft und dem Urteil der anderen orientiert
spleißen		split
Staffelei		slikarsko stojalo
stämmig		stocky/sturdy/thickset
Standpauke		telling-off, lecture
sternhagelvoll		völlig, sinnlos betrunken
stöbern		to browse (brskati/šariti)
stockfinster		Pitch-dark
Stoppel		štopl (ÖER) ODER plug za pšenico
störrisch		stubborn
streifen		flüchtig berühren ODER flüchtig erwähnen ODER to slip over
süffisant		smug
Sund		Meerenge
Tafelwasser		Mineralwasser in Flaschen
Tand		wertloses Zeug
täppisch		awkward
Tau		dew (Tautropfen)
Taubstummer		Gehörloser (soll nicht mehr gebraucht werden!)
Taumel		dizziness/frenzy
Tic		in kurzen Abständen wiederkehrende, unwillkürliche, nervöse Muskelzuckung (besonders im Gesicht)
Tiergeripp		?
tönern		clay (glinen)
Torheit		mangelnde Klugheit; Dummheit (1), Unvernunft
töricht		unklug, unvernünftig ODER (seltener) lächerlich, albern
Trag		through (dolinica)
träge		sluggish/dull/inert/lethargic
traktieren (jmd traktieren)		to abuse/ill-treat sb/sth
Treibgut		etwas, was als herrenloses Gut (Stoff) auf dem Wasser, besonders auf dem Meer, treibt
triftig		good/acceptable/convincing
Trödel		junk
trüb		unklar/misty/dull/dim/bleak
Trug		Betrug oder Sinnestäuschung
Tugend		virtue (vrlina)
tugendhaft		den geltenden sittlichen Normen gemäß lebend, sich verhaltend; sittlich einwandfrei; moralisch untadelig, vorbildlich
tugendreich		den geltenden sittlichen Normen gemäß lebend, sich verhaltend; sittlich einwandfrei; moralisch untadelig, vorbildlich
Tümpel		small pond
tuscheln		to gossip
u.v.m.		und vieles mehr
Unbehagen		uneasiness/disquiet/concern
Unbehaglichkeit		Discomfort/Awkwardness
Unbill		üble Behandlung; Unrecht; etwas Übles, was jemand zu ertragen hat
ungestüm		seinem Temperament, seiner Erregung ohne jede Zurückhaltung Ausdruck gebend; stürmisch, wild ODER wild, heftig, unbändig
Unterfangen		Undertaking
unterhaken		mit einem Haken befestigen, durch einen Haken verschließen, mit etwas verbinden ODER seinen Arm in den angewinkelten Arm eines andern schieben, legen ODER jemandes Gespräch, Rede o. Ä. unterbrechen, um sich zu einem bestimmten Punkt, meist mit einem Einwand, zu äußern
unterminieren		to undermine
untersetzt		čokat/stocky
unvoreingenommen		unbiased/impartial
urtümlich		ancient/primeval
Vehikel		vehicle, meistens als ein altes Wagen gemeint
verdenken (jdm etw verdenken)		to hold sth against sb (to blame someone for something subconsciously)
verdorren		durch große Hitze, Trockenheit völlig vertrocknen, dürr werden [und absterben]
Verdruss		annoyance
verebben		upadati, ponehati
verflechten (verflochten PER)		interweaved/intertwined
vergaffen		sich verlieben
vergällt		etwas denaturieren (2), um es ungenießbar zu machen ODER jemanden die Freude an etw verderben
verharren		stehen bleiben ODER to persist
verheddern		to tangle uo
verhöhnen		sich aus jmd lustig machen (to mock)
Verlegenheit		embarassment
verlottert		run-down/scruffy/diplapidated/slovenly
vermaledeit		damnable/blasted
Vernehmung		Verhör
verprasst		finanziell ausgeberisch
verrenken		to twist/to dislocate
verrenken		durch eine übermäßige oder unglückliche Bewegung aus der normalen Lage im Gelenk bringen, drehen [und dadurch das Gelenk verletzen]
Verrenkungen		izpah (verletzung) ODER zvijanje (contorting)
verrichten		to perform/to carry out
Verschleiß		obraba/attrition/wearing and tearing out
verschmähen (etw verschmähen)		to reject/scorn sth
verseiben		aus Unachtsamkeit verlieren, verlegen
versengen		Osmoditi (durch leichtes Anbrennen besonders der Oberfläche beschädigen)
versohlen		verhauen
versonnen		seinen Gedanken nachhängend (und dabei seine Umgebung vergessend); träumerisch
verulken		to make fun of
Verunglimpfung		vilification (Verleumdung)
verwahrlost		äußerst ungepflegt, heruntergekommen
verweilen		sich aufhalten/sich irgendwo befinden/sich mit etw beschäftigen
verwöhnt		spoiled/bad
verworren		confused/complicated
Verzehr		consumption
Verzückung		in einen Zustand höchster Begeisterung, in Ekstase versetzen
Vesikel		cyst (Golgi-Vesikel)
vogelfrei		outlawed
Vollpfosten		dumbass
Vormundschaft		(amtlich verfügte) Wahrnehmung der rechtlichen Vertretung eines oder einer Minderjährigen (früher auch eines oder einer Entmündigten)
Vortrefflichkeit		excellence
Wahn		Einbildung, irrige Annahme; falsche Vorstellung, die sich bei jemandem festgesetzt hat oder krankhafte, in der realen Umwelt nicht zu begründende zwanghafte Einbildung
Walpurgisnacht		Hexenbrennen Feiertag (tipično se postavi kres)
Wedel		feather duster (typically Staubwedel)
wedeln		mahati
Wehmut		verhaltene Trauer, stiller Schmerz bei der Erinnerung an etwas Vergangenes, Unwiederbringliches
weichen (etw weichen)		to give way to sth ODER to go
weidlich		pretty
Windbö		sunek vetra
Witterung		Wetter ODER Geruchssinn ODER Ahnungsvermögen
wogend		rough/choppy/heaving in the sense of sea/ocean
Wonne		joy
wühlen		to dig/to rummage through sth/to stir things up (kopati/riti/brskati)
Wust		pile
Yuppie		junger, karrierebewusster, großen Wert auf seine äußere Erscheinung legender Stadtmensch, Aufsteiger
zagen		to hesitate
zaghaft		timid (obotavljiv, neodločen, plah)
zäh		eine zähflüssige, teigige Beschaffenheit aufweisend ODER nur sehr mühsam, langsam [vorankommend], schleppend ODER eine Konstitution aufweisend, die auch stärkeren Belastungen und Beanspruchungen standhält
Zaster		keš (slang)
Zaunpfahl		fence post (drahtny kól)
Zechbruder		1) Trinker 2) Zechgenosse (männliche Person, die mit einem anderen, mit anderen zusammen trinkt)
Zeche		coal mine ODER bill/Rechnung
zechen		to nooze
Zerwürfnis		row/disagreement
zerzausen		skuštrano
ziemen		passend verhalten/sein
Zierde		ornament/decoration
zimperlich		sensitive (being a sissy)
Zipfel		corner ODER tail ODER Saum
Zirpen		Grille, Zikade
Züchtigungen		durch Schlagen hart bestrafen
Zueignung		appropriation ODER Widmung/dedication
Zuhälter		Ausbeuter von Prostituierten oder Strichjungen meist durch eine männliche Person, die ihre Vermittlung und ihren Schutz gegen eine Teilhabe an ihren Einkünften übernimmt
zünf­tig		fachmännisch, fachgerecht ODER ordentlich ODER zu einer Zunft gehörend
zwangsläufig		inevitable
zwiespältig		conflicting/mixed/ambivalent
zürnen		zornig, ärgerlich auf jemanden sein; jemandem grollen, böse sein
zudringlich		durch aufdringliches Verhalten lästig fallend; in belästigender Weise sich jemandem körperlich nähernd
zaudern		unentschlossen zögern; unschlüssig sein
Tauwetter		(auf Frost folgende) wärmere Witterung, bei der Schnee und Eis schmelzen
tiefsinnig		Neigung, tief in das Wesen der Dinge einzudringen; grüblerisches Nachdenken
Wacke		kleinerer [verwitternder] Gesteinsbrocken
buhlen		1) heftig um etwas werben, sich um etwas bemühen ODER 2) mit jemandem kosen, eine Liebschaft haben
stieben		1) (wie Staub) in Teilchen auseinanderwirbeln ODER 2) rasch [und panikartig] irgendwohin davonlaufen, auseinanderlaufen, davonfahren
unbändig		ungestüm, wild ODER durch nichts gedämpft, abgemildert, sich ohne Beschränkung äußernd; nicht zu zügeln; heftig
Schelle		Ohrfeige ODER ringförmige Klammer, Bügel zum Befestigen und Verbinden von Rohren und Schläuchen o. Ä. oder zum Befestigen von Teilen an Rohren
verwelken		wither
Kniff		pinch ODER scharf umgebogene Stelle in Papier oder Stoff; Falte, Knick ODER bestimmte, praktische Methode, Handhabung von etwas zur Erleichterung oder geschickten Ausführung einer Arbeit
unerbitterlich		relentless
Bescherung		Jemanden etwas schenken ODER unangenehme Überraschung
bescheren		etwas erhalten
rege		stets in Tätigkeit, in Bewegung; lebhaft, nicht träge
Reigen		von Gesang begleiteter [Rund]tanz, bei dem eine größere Zahl von Tänzerinnen und Tänzern [paarweise] einem Vortänzer und Vorsänger schreitend oder hüpfend folgt
ersinnen		sich etwas ausdenken
Pirsch		Art der Jagd, bei der versucht wird, durch möglichst lautloses Durchstreifen eines Jagdreviers Wild aufzuspüren und sich ihm auf Schussweite zu nähern (auf die Pirsch zu gehen)
Annalen		chronologisch geordnete Aufzeichnungen von [geschichtlichen] Ereignissen; Jahrbücher
be­flü­geln		anregen, beleben; jemandem, einer Sache Antrieb zu etwas geben; anspornen ODER dazu beitragen, dass etwas schneller wird
Schwall		mit einer gewissen Heftigkeit sich ergießende, über jemanden, etwas hereinbrechende Menge von etwas, besonders einer Flüssigkeit
landläufig		allgemein verbreitet, bekannt; allgemein üblich, gängig
beimmist		beimessen (veraltet PRÄ)
scheren		mithilfe einer Schere o. Ä. von Haaren befreien
resolut		sehr entschlossen und mit dem Willen, sich durchzusetzen; in einer Weise sich darstellend, sich äußernd, die Entschlossenheit, Bestimmtheit zum Ausdruck bringt  
Aufwiegelung		Ugrabitev/Ustrahovanje
umgarnen		durch Schmeichelei, Koketterie o. Ä. für sich zu gewinnen suchen
geschürzt	(meistens leicht geschürzt)	wenig bekleidet
balgen		prügeln/sich [um etwas] ringend mit jemandem auf dem Boden wälzen
Moloch		grausame Macht, die immer wieder neue Opfer fordert und alles zu verschlingen droht
Gehöft		domačija
Bug		vorderster Teil eines Schiffes, Flugzeugs, seltener auch eines Autos
Kahn		kleines, offenes, flaches Boot zum Rudern oder Staken
tuckern		gleichmäßig aufeinanderfolgende klopfende, stumpf-harte Laute von sich geben
wispern		flüstern
Schindeln		plošče auf strehi
Fuge		joint
Schiefer		slate
wuchern		proliferate/sprawling
Posaunenstoß		Trombone/Trumpet blast
speien		spucken
brunsten		in der Brunst sein
Brunst		Zeit der Paarung bzw. der Paarungsbereitschaft bei Säugetieren
ungeschlacht		mit einem sehr großen, massigen, plumpen und unförmigen [Körper]bau versehen
Maden		larvae
Seim		klebrige, zähe Flüssigkeit
Canker		rakavost
träufen		in zahlreichen kleineren Tropfen fallen, herausfließen, heraustreten lassen
Unflat		widerlicher, ekelhafter Schmutz, Dreck
Wechte (auch Wächte)		besonders am Rand von Steilhängen, Graten durch den Wind angewehte, überhängende Schneemasse
Saite		string/chord
Klecks		Farb-, Tintenfleck, kleine Menge einer weichen zum Gebrauch irgendwohin beförderten Masse
Unrat		etwas, was aus Abfällen, Weggeworfenem besteht
Rinne		navigational water channel; schmale, lang gestreckte Vertiefung im Boden, durch die Wasser fließt oder fließen kann
teeren		prekriti s smolo
quirlen		1) pucat z metlico za stepanje ODER 2) sich ungeordnet lebhaft [im Kreise] bewegen; sich schnell drehen
brabbeln		undeutlich vor sich hin reden
Scherbe		Stück von einem zerbrochenen Gegenstand aus Glas, Porzellan oder Ton
zerren		mühsam oder mit Gewalt, gegen einen Widerstand, meist ruckartig ziehen, ziehend fortbewegen
bramarbasieren		prahlen, aufschneiden
Alfanzerei		silliness
verschnörkelt		mit Schnörkeln versehen, verziert (an ornamental stroke of the pen in writing)
Lettern		letter
bestallen		in ein Amt einsetzen, zu etwas ernennen
belustigen		fröhlich stimmen, zum Lachen bringen

